==========
=>.......=
========.=
=......=.=
==.=.=...=
=..=..=.==
=.===.=..=
=..==G==.=
==========
==========